[Level]
1
00001111111111110000
00012121211212121000
00121212122121212100
00212121355312121200
00021212122121212000
00041111111111114000
00044444444444444000
00043939399393934000
00044444444444444000
00000000000000000000
00000000000000000000
00000000000000000000
00000000000000000000
00000000000000000000
00000000000000000000
00000000000000000000
00000000000000000000
00000000000000000000
00000000000000000000
00000000000000000000
[Level]
2
02222222222222222220
01222122111212111110
01222121222222222120
01212122112212221220
01121122221212212220
01222121112212111110
02222222222222222220
09999999999999999990
09393939399393939390
04444444444444444440
00000000000000000000
00000000000000000000
00000000000000000000
00000000000000000000
00000000000000000000
00000000000000000000
00000000000000000000
00000000000000000000
00000000000000000000
00000000000000000000
[Level]
3
00000001111000000000
00000112222110000000
00001222222221000000
00012222222222100000
00012222222222100000
00122222222522210000
00122222222222210000
00122222222222111000
01222222222111000050
01222221111000000535
01222222222111000050
01222222222222111000
00122222222222210000
00122222222222210000
00122222222222210000
00012222222222100000
00012222222222100000
00001222222221000000
00000112222110000000
00000001111000000000
[Level]
0
00000000555500000000
00000055555555000000
00000555555555500000
00005555555555550000
00005555555555550000
00055555555555555000
00055555555515555000
00055555555515555000
00055555555505555000
00055555555555555000
00055555555555555000
00055555555555555000
00055555555555555000
00055555555555555000
00055555555555555000
00055555555555555000
00055555555555555000
00050505050505050000
00000000000000000000
00000000000000000000
[Level]
-1
00000000000000000000
00000000000000000000
00000000000000000000
00000000000000000000
00000000000000000000
00000000000000000000
00000000000000000000
00000000000000000000
00000000000000000000
00000000000000000000
00000000000000000000
00000000000000000000
00000000000000000000
00000000000000000000
00000000000000000000
00000000000000000000
00000000000000000000
00000000000000000000
00000000000000000000
00000000000000000000